- README: README.md
- 0.0 GridLAB-D: TODO.md
- custom_blocks:
  - Contact: custom_blocks\Contact.md
- docs:
  - 0.0 GridLAB-D™:
    - Contacts: docs\0.0 GridLAB-D™\Contacts_list.md
    - Announcements: docs\0.0 GridLAB-D™\Version History.md
    - projects: docs\0.0 GridLAB-D™\projects.md
    - publications: docs\0.0 GridLAB-D™\publications.md
    - Source: docs\0.0 GridLAB-D™\resources.md
    - GridLAB-D™: docs\0.0 GridLAB-D™\style-guide.md
  - 1.0 Prospective Users:
    - Key Attributes of GridLAB-D™: docs\1.0 Prospective Users\GridLAB-D_Key_Attributes.md
    - Capabilities: docs\1.0 Prospective Users\Technical_Overview.md
  - 2.0 New Users:
    - Getting_Started_Using_GridLAB-D: docs\2.0 New Users\Getting_Started_Using_GridLAB-D.md
    - Installation:
      - Mysql: docs\2.0 New Users\Installation\Mysql#username.md
    - Mysql: docs\2.0 New Users\Mysql.md
    - Theory of Operation: docs\2.0 New Users\theory-of-operation.md
  - 3.0 Modeling:
    - CSV reader (climate class): docs\3.0 Modeling\CSV_reader_(climate_class).md
    - Commercial User Guide: docs\3.0 Modeling\Commercial_User_Guide.md
    - Creating GLM Files: docs\3.0 Modeling\Creating_GLM_Files.md
    - Creating a module: docs\3.0 Modeling\Creating_runtime_modules.md
    - Database: docs\3.0 Modeling\Database.md
    - Subsecond: docs\3.0 Modeling\Delta_mode.md
    - Dev:Commercial: docs\3.0 Modeling\Dev_Commercial.md
    - Dev:Import/export: docs\3.0 Modeling\Dev_Import_export.md
    - Dev:Microgrids: docs\3.0 Modeling\Dev_Microgrids.md
    - Dev:filter: docs\3.0 Modeling\Dev_filter.md
    - Droop inverter: docs\3.0 Modeling\Droop_inverter.md
    - ETP closed form solution: docs\3.0 Modeling\ETP_closed_form_solution.md
    - Energy storage: docs\3.0 Modeling\Energy_storage.md
    - Engine link: docs\3.0 Modeling\Engine_link.md
    - Engine protocol: docs\3.0 Modeling\Engine_protocol.md
    - Escape character: docs\3.0 Modeling\Escape_character.md
    - Evcharger: docs\3.0 Modeling\Evcharger.md
    - Evcharger det: docs\3.0 Modeling\Evcharger_det.md
    - Event trace filter: docs\3.0 Modeling\Event_trace_filter.md
    - GLM Loading FAQ: docs\3.0 Modeling\GLM_Loading_FAQ.md
    - GLM syntax: docs\3.0 Modeling\GLM_syntax.md
    - Generators Module Guide: docs\3.0 Modeling\Generators_Module_Guide.md
    - Generic Schedule Object: docs\3.0 Modeling\Generic_Schedule_Object.md
    - Heartbeat: docs\3.0 Modeling\Heartbeat.md
    - Tape Histogram Guide: docs\3.0 Modeling\Tape_Histogram_Guide.md
    - History: docs\3.0 Modeling\History.md
    - House: docs\3.0 Modeling\House.md
    - HowTo:Create a movie: docs\3.0 Modeling\HowTo_Create_a_movie.md
    - HowTo:mysql: docs\3.0 Modeling\HowTo_mysql.md
    - Hybrid Electric Vehicle Chargers: docs\3.0 Modeling\Hybrid_Electric_Vehicle_Chargers.md
    - Impedance dump: docs\3.0 Modeling\Impedance_dump.md
    - Implicit enduses: docs\3.0 Modeling\Implicit_enduses.md
    - Industrial and agricultural loads: docs\3.0 Modeling\Industrial_and_agricultural_loads.md
    - Initialization: docs\3.0 Modeling\Initialization.md
    - Integral: docs\3.0 Modeling\Integral.md
    - Inverter: docs\3.0 Modeling\Inverter.md
    - Inverter dyn: docs\3.0 Modeling\Inverter_dyn.md
    - Lights: docs\3.0 Modeling\Lights.md
    - Link (directive): docs\3.0 Modeling\Link_(directive).md
    - Load Composition: docs\3.0 Modeling\Load_Composition.md
    - Loadshape: docs\3.0 Modeling\Loadshape.md
    - Macros: docs\3.0 Modeling\Macros.md
    - Market Auction: docs\3.0 Modeling\Market_Auction.md
    - Market User Guide: docs\3.0 Modeling\Market_User_Guide.md
    - Matlab link: docs\3.0 Modeling\Matlab_link.md
    - Metrics collector: docs\3.0 Modeling\Metrics_collector.md
    - Metrics collector writer: docs\3.0 Modeling\Metrics_collector_writer.md
    - Microwave: docs\3.0 Modeling\Microwave.md
    - Model Debugging: docs\3.0 Modeling\model-debugging.md
    - Modeling Reference:
      - Checkpoints: docs\3.0 Modeling\Modeling Reference\Checkpoints.md
      - Command_options: docs\3.0 Modeling\Modeling Reference\Command_options.md
      - Modules:
        - Assert (module): docs\3.0 Modeling\Modeling Reference\Modules\Assert.md
        - Climate Module: docs\3.0 Modeling\Modeling Reference\Modules\Climate.md
      - Units: docs\3.0 Modeling\Modeling Reference\Units.md
    - Modify: docs\3.0 Modeling\Modify.md
    - Modules: docs\3.0 Modeling\Module_Guide.md
    - Module functions: docs\3.0 Modeling\Module_functions.md
    - Module globals: docs\3.0 Modeling\Module_globals.md
    - Mt profile: docs\3.0 Modeling\Mt_profile.md
    - Multi recorder: docs\3.0 Modeling\Multi_recorder.md
    - Multirun mode: docs\3.0 Modeling\Multirun_mode.md
    - Multithreaded Random Number Generation: docs\3.0 Modeling\Multithreaded_Random_Number_Generation.md
    - MySQL Import/Export: docs\3.0 Modeling\MySQL_Import_Export.md
    - NEV: docs\3.0 Modeling\NEV.md
    - NEVLoads: docs\3.0 Modeling\NEVLoads.md
    - NEVOverhead: docs\3.0 Modeling\NEVOverhead.md
    - NEVTransformer: docs\3.0 Modeling\NEVTransformer.md
    - NEVUnderground: docs\3.0 Modeling\NEVUnderground.md
    - Network: docs\3.0 Modeling\Network_Flow_Solver.md
    - Network Flow Guide: docs\3.0 Modeling\Network_Flow_Guide.md
    - Newton-Raphson Distribution Powerflow Solver: docs\3.0 Modeling\Newton-Raphson_Distribution_Powerflow_Solver.md
    - Object (directive): docs\3.0 Modeling\Object_(directive).md
    - Object (property): docs\3.0 Modeling\Object_(property).md
    - Objects:
      - Appliance: docs\3.0 Modeling\Objects\Appliance.md
      - Diesel dg: docs\3.0 Modeling\Objects\Diesel_dg.md
      - Loads: docs\3.0 Modeling\Objects\Loads.md
      - Solar - Solar Panel: docs\3.0 Modeling\Objects\Solar.md
      - Tech:Commercial: docs\3.0 Modeling\Objects\Tech_Commercial.md
      - Tech:Residential: docs\3.0 Modeling\Objects\Tech_Residential.md
      - Voltage source inverter (VSI): docs\3.0 Modeling\Objects\Voltage_source_inverter_(VSI).md
      - Windturb dg: docs\3.0 Modeling\Objects\Windturb_dg.md
      - Object (directive): docs\3.0 Modeling\Objects\Writing_Objects.md
      - ZIPload: docs\3.0 Modeling\Objects\ZIPload.md
      - house-e: docs\3.0 Modeling\Objects\house-e.md
    - Office: docs\3.0 Modeling\Office.md
    - Orientation: docs\3.0 Modeling\Orientation.md
    - Output: docs\3.0 Modeling\Output.md
    - PQ CONSTANT mode diesel dg: docs\3.0 Modeling\PQ_CONSTANT_mode_diesel_dg.md
    - Parameter expansion: docs\3.0 Modeling\Parameter_expansion.md
    - Pauseat: docs\3.0 Modeling\Pauseat.md
    - Pcontrol: docs\3.0 Modeling\Pcontrol.md
    - Performance profiling: docs\3.0 Modeling\Performance_profiling.md
    - Player: docs\3.0 Modeling\Player.md
    - Player (mysql): docs\3.0 Modeling\Player_(mysql).md
    - Powerflow: docs\3.0 Modeling\Powerflow_meter.md
    - Power Flow User Guide: docs\3.0 Modeling\Powerflow_User_Guide.md
    - Powerflow (module): docs\3.0 Modeling\Powerflow_(module).md
    - Programming conventions: docs\3.0 Modeling\Programming_conventions.md
    - Property calculations: docs\3.0 Modeling\Property_calculations.md
    - Python: docs\3.0 Modeling\Python.md
    - RUN: docs\3.0 Modeling\RUN.md
    - Randomvar: docs\3.0 Modeling\Randomvar.md
    - Random number generator: docs\3.0 Modeling\Random_number_generator.md
    - Random numbers: docs\3.0 Modeling\Random_numbers.md
    - Range: docs\3.0 Modeling\Range.md
    - Real-time server: docs\3.0 Modeling\Real-time_server.md
    - Realtime metric: docs\3.0 Modeling\Realtime_metric.md
    - Realtime server: docs\3.0 Modeling\Realtime_server.md
    - Recorder: docs\3.0 Modeling\Recorder.md
    - Recorder (mysql): docs\3.0 Modeling\Recorder_(mysql).md
    - Redirect: docs\3.0 Modeling\Redirect.md
    - Refrigerator: docs\3.0 Modeling\Refrigerator.md
    - Reliability Module Guide: docs\3.0 Modeling\Reliability_Module_Guide.md
    - Reliability User Guide: docs\3.0 Modeling\Reliability_User_Guide.md
    - Reliability module: docs\3.0 Modeling\Reliability_module.md
    - Residential (module): docs\3.0 Modeling\Residential_(module).md
    - Residential module user's guide: docs\3.0 Modeling\Residential_module_user%27s_guide.md
    - Run realtime: docs\3.0 Modeling\Run_realtime.md
    - Running Simulations: docs\3.0 Modeling\Running_Simulations.md
    - Series compensator: docs\3.0 Modeling\Series_compensator.md
    - Skipsafe: docs\3.0 Modeling\Skipsafe.md
    - Transmission: docs\3.0 Modeling\Transmission.md
    - Tape (module): docs\3.0 Modeling\Tape_Module_Guide.md
    - Tech:CompositionMotor: docs\3.0 Modeling\Tech_CompositionMotor.md
    - Tech:DeltaSPIM: docs\3.0 Modeling\Tech_DeltaSPIM.md
    - Tech:DeltaTPIM: docs\3.0 Modeling\Tech_DeltaTPIM.md
    - Thermal Energy Storage model guide: docs\3.0 Modeling\Thermal_Energy_Storage_model_guide.md
    - Timezone: docs\3.0 Modeling\Timezone.md
    - Transactive Controller: docs\3.0 Modeling\TransactiveController.md
    - Validate: docs\3.0 Modeling\Validate.md
    - Finding Objects: docs\3.0 Modeling\finding-objects.md
    - house-e: docs\3.0 Modeling\house-e.md
    - intermediate-modeling:
      - Advanced_Distribution_Models: docs\3.0 Modeling\intermediate-modeling\Advanced_Distribution_Models.md
      - Aggregate demand response model: docs\3.0 Modeling\intermediate-modeling\Aggregate_demand_response_model.md
    - intro-to-modeling:
      - Basic Distribution System Modeling: docs\3.0 Modeling\intro-to-modeling\Modeling 101 - Basic Distribution System Modeling.md
      - Built-In Distribution Models: docs\3.0 Modeling\intro-to-modeling\Modeling 101 - Built-In Distribution Models.md
      - Distributed Generation: docs\3.0 Modeling\intro-to-modeling\Modeling 101 - Distributed_Generation.md
      - Introduction: docs\3.0 Modeling\intro-to-modeling\Modeling 101 - GLM Models.md
      - Modeling 101 - Modules: docs\3.0 Modeling\intro-to-modeling\Modeling 101 - Modules.md
      - Introduction to Recorders and Players: docs\3.0 Modeling\intro-to-modeling\Modeling 101 - Recorders and Players.md
      - Built in schedules and loadshapes: docs\3.0 Modeling\intro-to-modeling\Modeling 101 - Schedules and Loadshapes.md
    - Performance Profiling: docs\3.0 Modeling\performance-profiling.md
    - Plotting Output: docs\3.0 Modeling\plotting-output.md
    - Theory of Operation: docs\3.0 Modeling\theory-of-operation.md
  - 4.0 Developing:
    - API:
      - Dev:KML: docs\4.0 Developing\API\Dev_KML.md
      - Dev:Link: docs\4.0 Developing\API\Dev_Link.md
      - Dev:Locking: docs\4.0 Developing\API\Dev_Locking.md
      - Dev:Solvers: docs\4.0 Developing\API\Dev_Solvers.md
      - Dev:load method: docs\4.0 Developing\API\Dev_load_method.md
      - Dev:notify: docs\4.0 Developing\API\Dev_notify.md
      - Extern: docs\4.0 Developing\API\Extern.md
      - Gld object: docs\4.0 Developing\API\Object.md
      - PT ACCESS: docs\4.0 Developing\API\PT_ACCESS.md
      - Powerflow External LU Solver Interface: docs\4.0 Developing\API\Powerflow_External_LU_Solver_Interface.md
      - Publishing methods: docs\4.0 Developing\API\Publishing_methods.md
      - Publishing properties: docs\4.0 Developing\API\Publishing_properties.md
      - Using Global Variables: docs\4.0 Developing\API\Using_Global_Variables.md
      - Module globals: docs\4.0 Developing\API\globals.md
    - Build_Installation:
      - CMake Build | Building GridLAB-D: docs\4.0 Developing\Build_Installation\Build.md
      - Building and Releasing GridLAB-D: docs\4.0 Developing\Build_Installation\Building_for_release.md
      - Installing GridLAB-D™: docs\4.0 Developing\Build_Installation\Installing.md
    - Code templates: docs\4.0 Developing\Code_templates.md
    - Debugging:
      - Command options: docs\4.0 Developing\Debugging\Command_line_arguments.md
      - Performance Profiling: docs\4.0 Developing\Debugging\performance-profiling.md
    - Deltamode:
      - Dev:Subsecond: docs\4.0 Developing\Deltamode\Dev_Subsecond.md
    - Fundamentals:
      - Class: docs\4.0 Developing\Fundamentals\CLASS.md
      - Core Guide: docs\4.0 Developing\Fundamentals\Core_Guide.md
      - Creating a class: docs\4.0 Developing\Fundamentals\Creating_a_class.md
      - Creating a module: docs\4.0 Developing\Fundamentals\Creating_a_module.md
      - Dev:HowTo:Create a module: docs\4.0 Developing\Fundamentals\Dev_HowTo_Create_a_module.md
      - Environment: docs\4.0 Developing\Fundamentals\Environment.md
      - Gld object: docs\4.0 Developing\Fundamentals\Gld_object.md
      - How To Write GridLAB-D Modules: docs\4.0 Developing\Fundamentals\How_To_Write_GridLAB-D_Modules.md
      - Integrated Testing: docs\4.0 Developing\Fundamentals\Integrated_Testing.md
      - Introduction to Programming GridLAB-D: docs\4.0 Developing\Fundamentals\Introduction_to_Programming_GridLAB-D.md
      - Mainloop state: docs\4.0 Developing\Fundamentals\Mainloop_state.md
      - Code templates: docs\4.0 Developing\Fundamentals\Module_templates.md
      - Gld property: docs\4.0 Developing\Fundamentals\Property.md
      - intro-to-developing: docs\4.0 Developing\Fundamentals\intro-to-developing.md
    - Modules:
      - autotest:
        - Validate: docs\4.0 Developing\Modules\autotest\Validate_report.md
      - connections:
        - Connection: docs\4.0 Developing\Modules\connections\Connection.md
        - Connection:fncs msg: docs\4.0 Developing\Modules\connections\Connection_fncs_msg.md
        - Connection:helics msg: docs\4.0 Developing\Modules\connections\Connection_helics_msg.md
        - Connection:json: docs\4.0 Developing\Modules\connections\Connection_json.md
        - Connection:link: docs\4.0 Developing\Modules\connections\Connection_link.md
        - Connection:lockout: docs\4.0 Developing\Modules\connections\Connection_lockout.md
        - Connection:mode: docs\4.0 Developing\Modules\connections\Connection_mode.md
        - Connection:native: docs\4.0 Developing\Modules\connections\Connection_native.md
        - Connection:security: docs\4.0 Developing\Modules\connections\Connection_security.md
        - Connection:transport: docs\4.0 Developing\Modules\connections\Connection_transport.md
        - Connection:xml: docs\4.0 Developing\Modules\connections\Connection_xml.md
        - Dev:connection: docs\4.0 Developing\Modules\connections\Dev_connection.md
        - Dev:mysql: docs\4.0 Developing\Modules\connections\Dev_mysql.md
      - gldcore:
        - Glengine: docs\4.0 Developing\Modules\gldcore\Glengine.md
      - optimization:
        - Optimize: docs\4.0 Developing\Modules\optimization\Optimize.md
        - Tech:Optimize: docs\4.0 Developing\Modules\optimization\Tech_Optimize.md
      - powerflow:
        - HowTo:Create a solver: docs\4.0 Developing\Modules\powerflow\HowTo_Create_a_solver.md
      - residential:
        - Tech:Multizone ETP Linearization: docs\4.0 Developing\Modules\residential\Tech_Multizone_ETP_Linearization.md
    - Dev:class: docs\4.0 Developing\Style_guide.md
  - 5.0 Integration:
    - Interfacing_with_External_Software: docs\5.0 Integration\Interfacing_with_External_Software.md
    - intro-to-integration: docs\5.0 Integration\intro-to-integration.md
  - 6.0 Examples:
    - Placeholder: docs\6.0 Examples\placeholder.md
  - 7.0 References:
    - Specs:
      - Communications: docs\7.0 References\Specs\Spec-Communicatins.md
      - Spec:Commercial: docs\7.0 References\Specs\Spec_Commercial.md
      - Spec:Dishwasher: docs\7.0 References\Specs\Spec_Dishwasher.md
      - Spec:GUI: docs\7.0 References\Specs\Spec_GUI.md
      - Spec:Initialization: docs\7.0 References\Specs\Spec_Initialization.md
      - Spec:Market: docs\7.0 References\Specs\Spec_Market.md
      - Spec:Mesh Fault Current: docs\7.0 References\Specs\Spec_Mesh_Fault_Current.md
      - Spec:Microgrids: docs\7.0 References\Specs\Spec_Microgrids.md
      - Spec:Multirun mode: docs\7.0 References\Specs\Spec_Multirun_mode.md
      - Spec:NEV: docs\7.0 References\Specs\Spec_NEV.md
      - Spec:NEVArray: docs\7.0 References\Specs\Spec_NEVArray.md
      - Spec:NEVDataFormat: docs\7.0 References\Specs\Spec_NEVDataFormat.md
      - Spec:NEVLink: docs\7.0 References\Specs\Spec_NEVLink.md
      - Spec:NEVModules: docs\7.0 References\Specs\Spec_NEVModules.md
      - Spec:NEVNode: docs\7.0 References\Specs\Spec_NEVNode.md
      - Spec:NEVSolver: docs\7.0 References\Specs\Spec_NEVSolver.md
      - Spec:Optimize: docs\7.0 References\Specs\Spec_Optimize.md
      - Spec:Range: docs\7.0 References\Specs\Spec_Range.md
      - Spec:Residential: docs\7.0 References\Specs\Spec_Residential.md
      - Spec:Subsecond: docs\7.0 References\Specs\Spec_Subsecond.md
      - Spec:Transmission: docs\7.0 References\Specs\Spec_Transmission.md
      - Spec:ibr blackboxmodels: docs\7.0 References\Specs\Spec_ibr_blackboxmodels.md
      - Spec:ibr grayboxmodels: docs\7.0 References\Specs\Spec_ibr_grayboxmodels.md
      - Spec:inverter dyn: docs\7.0 References\Specs\Spec_inverter_dyn.md
      - Spec:particle swarm optimizer: docs\7.0 References\Specs\Spec_particle_swarm_optimizer.md
      - Spec:sec control: docs\7.0 References\Specs\Spec_sec_control.md
      - Spec:switch object: docs\7.0 References\Specs\Spec_switch_object.md
      - Spec:sync check: docs\7.0 References\Specs\Spec_sync_check.md
      - Spec:sync ctrl: docs\7.0 References\Specs\Spec_sync_ctrl.md
  - GridLAB-D Documentation Outline: docs\outline.md
- images:
- GridLAB-D: A Unique Tool to Design the Smart Grid: index.md
- reference:
  - ReadMeConfig:
    - authentication: reference\ReadMeConfig\authentication.md
    - getting-started: reference\ReadMeConfig\getting-started.md
    - my-requests: reference\ReadMeConfig\my-requests.md
- src:
  - md_merger:
    - sandbox:
      - CMake Build: src\md_merger\sandbox\foo.md
      - Eclipse: src\md_merger\sandbox\Eclipse.md
      - Getting_Started_Using_GridLAB-D: src\md_merger\sandbox\Getting_Started_Using_GridLAB-D.md
      - Introduction to Programming GridLAB-D: src\md_merger\sandbox\Introduction_to_Programming_GridLAB-D.md
      - Mac OSX/Setup: src\md_merger\sandbox\Mac_OSX_Setup.md
  - screen_scraper:
